GotTheBeat : StampOnIt | GoddessLevel | AlterEgo | Rose | Outlaw | Mala
Twice : MoolightSunrise | HareHare | SetMeFree
Yena : WashAway | LoveWar | BadHobby | WickedLove
LeSserafim : Choices | Unforgiven | Eve,Psyche&Bluebeard'sWife | FireInTheBelly | PerfectNight
Stayc : Poppy | TeddyBear | Bubble
Nct127 : Skyscraper | FactCheck | JeNeSaisQuoi
NctU : BaggyJeans | CallD | AlleyOop | That'sNotFair
NctDojaejung : Perfume
TripleS : Rising | TheBaddest | NewLook | DejaVu | MotoPrincess | JustDoIt
PurpleKiss : T4ke | Autopilot | Agit | SweetJuice
StrayKids : There | SClass
Tri.Be : Witch | WouldYouRun
Enhypen : BiteMe | Sacrifice | Chaconne | Bills | SweetVenom
Ive : BlueBlood | IAm | Kitsch | NextPage | Cherish | Lips | Hypnosis | Wave | Classic | IWant | Baddie | HolyMoly | OffTheRecord | EitherWay
Soyeon,Winter,Liz : Nobody
Sorn,Yeeun : NirvanaGirl
Aespa : Spicy | Salty&Sweet | WelcomeToMyWorld | BetterThings | Thirsty | ZoomZoom | Drama | TrickOrTrick | Don'tBlink | HotAirBalloon
(G)idle : Queencard | Lucid | IWantThat | EyesRoll | FlipIt
Ikon : RumPumPum | AllTheWayHere | Fighting1 | WantYouBack
NewJeans : Zero | NewJeans | SuperShy | Eta | CoolWithYou | GetUp | Asap | Gods | Omg
Nmixx : LoveMeLikeThis | Sonar(Breaker) | PartyO'Clock | RollerCoaster
Misamo : DoNotTouch | Marshmallow
Taeyong : BackToThePast | Gwando
Mave : Pandora | Wonderland
Kard : Icky | FxxkYou | Cake1
AgustD : Haegeum | Amygdala | PeoplePt.2 | DDay
Billlie : ExtraOrdinary | Byob | Eunoia
Xg : ShootingStar | LeftRight | GrlGvng | Tgif | NewDance | PuppetShow | XGene | WinterWithoutYou
LeeChaeYeon : Knock | IDon'tWannaKnow
Kai : Rover
Itzy : BetOnMe | Cake2 | NoneOfMyBusiness | Ringo | SugarHolic | Style | KillShot
Viviz : PullUp | LoveOrDie | Untie | Maniac
Yeeun : CherryCoke
ZiorPark : Sasquatch
Exo : HearMeOut | CreamSoda | RegretIt | PrivateParty | Cinderella | LoveFool | LetMeIn
KissOfLife : Shhh | Sugarcoat | Countdown | KittyCat | PlayLoveGames
Fromis9 : #Menow | Attitude
P1Harmony : Jump
Kep1er : Giddy | Lvly | TheDoor | LoveOnLock | TropicalLight
Ateez : Bouncy | CrazyForm
OddEyeCircle : AirForceOne
Jimin : SetMeFreePt.2
JungKook : Seven
JeonSomi : FastForward | FxxkedUp | Pisces | TheWay | GoldGoldGold
Shinee : Hard | Juice
Jihyo : Killin'MeGood | Talkin'AboutIt | Closer | WishingOnYou | Don'tWannaGoBack | Nightmare
Hyo : Picture
Bibi : HongdaeR&B | Amigos
QueenzEye : UnNormal
Seventeen : Fire | IDon'tUnderstandButILuvU | Sos | GodOfMusic | DiamondDays | Monster | Super
Loossemble : Sensitive | RealWorld | Colouring
Dynamicduo,LeeYoungJi : Smoke
Taeyong,Ten : Swipe
Miyeon,Yuqi : HowToTwerk
Bewhy : HolyToast
Akmu : LoveLee
Hwasa : Chili
El7zUp : Cheeky | Undercover | Hideaway
Lightsum : HoneyOrSpice | NotMyStyle | LightItUp
Loco : NotOk | Heee!
Sunmi : _Stranger
Jessi : Gum
WheeIn : 17 | OnTheIsland | InTheMood
Ph1 : Rosetta | Move!
Bobby : Hercules!
Jini : HereWeGoAgain
DprIan : BadCold | SoIDanced | VioletCrazy | Don'tGoInsane
Taemin : Guilty | TheRizzness
Soojin : Agassy
B.I : TheIslandOfMisfitToys | DieForLove | DareToLove | Loved
RedVelvet : ChillKill | OneKiss
WayV : Poppin'Love
Babymonster : _BatterUp
Heejin : VideoGame | Addiction
Taeyeon : _To.X
Bss,LeeYoungJi : Fighting2
CherryBullet : P.O.W! | WhistleLikeThat | Queen
Bella : Juice
H1Key : RoseBloom
JeonSomi,BigNaughty : ExMas